XXXXXXXXXXXX
XXX      XXX
XXXX     XXX
XXX      XXX
XXXXX    XXX
XXXX     XXX
XXX      XXX
XXXXXXXXXXXX
