XXXXXXXXXXXX
XXX      XXX
XXXX     XXX
XXX      XXX
XXXXX  XXXXX
XXXX    XXXX
XXX      XXX
XXXXXXXXXXXX
